1111111111111111111111111111111111111111111111
1E0000000000000000C0000000000000000C0000000001
1010010100100010000101100100100010001001001001
1010010010101001010001010010010001000100100101
1P0000000C00C000C0000000C00C00C000C000C00C00C1
1111111111111111111111111111111111111111111111
