1111111111111
10000000000C1
11100000000C1
1P1C0000E0001
1111111111111